''''''''''''''''''''''''''''''''''''''''''''''''''''''''''''''''''''''''''''''''
''''''''''''''''''''''''''''''''''''''''''''''''''''''''''''''''''''''''''''''''
''''''''''''''''''''''''''''''''''''''''''''''''''''''''''''''''''''''''''''''''
''''''''''''''''''''''''''''''''''''''''''''''''''''''''''''''''''''''''''''''''
--------------------------------------------------------------------------------
|..........................|......................|..|.........................|
|.............-------------|....................--|............................|
-----......................|......................----.........................|
''''|...............|......|........................|..........................|
''''|...............--------........................|..........................|
------|---------!-+-|...............................=..........................|
|.....|........................---------...------+--|..........................|
1..............................|'''''''|...|........=..........................|
1..............................|'''''''|...|........|..........................|
|.....|........................---------...---------|..........................|
------|.............................................|---------------------+----|
''''|...............................................|..........................|
''''|...............................................|..........................|
-----............................-------------------|..........................|
|................................|..................=..........................|
|................................|..................|---------------------------
|................................|..................|'''''''''''''''''''''''''''
|................................|..................|'''''''''''''''''''''''''''
|................................|..................|'''''''''''''''''''''''''''
|................................|..................|'''''''''''''''''''''''''''
-----------------------------------------------------'''''''''''''''''''''''''''
''''''''''''''''''''''''''''''''''''''''''''''''''''''''''''''''''''''''''''''''
''''''''''''''''''''''''''''''''''''''''''''''''''''''''''''''''''''''''''''''''
''''''''''''''''''''''''''''''''''''''''''''''''''''''''''''''''''''''''''''''''