''''''''''''''''''''''''''''''''''''''''''''''''''''''''''''''''''''''''''''''''
----------------------------''''''''''''''''''''''''''''''''''''''''''''''''''''
|....|............o........|''''''''''''''''''''''''''''''''''''''''''''''''''''
|....o............|........|''''''''''''''''''''''''''''''''''''''''''''''''''''
|....o............o........|''''''''''''''''''''''''''''''''''''''''''''''''''''
|-O----O----O-----|........|''''''''''''''''''''''''''''''''''''''''''''''''''''
|....o............o........|''##########''''''''''''''''''''''''''''''''''''''''
|....o............|........|''##########''''''''''''''''''''''''''''''''''''''''
|....|............o........|''##########''''''''''''''''''''''''''''''''''''''''
|-O-O--------O---O------O--|''##########''''''''''''''''''''''''''''''''''''''''
|.........|..........|.....|''##########''''''''''''''''''''''''''''''''''''''''
|.........|..........o.....=############''''''''''''''''''''''''''''''''''''''''
|.........|..........--O---|''''''''''''''''''''''''''''''''''''''''''''''''''''
|.........|................|''''''''''''''''''''''''''''''''''''''''''''''''''''
|.........o................|''''''''''''''''''''''''''''''''''''''''''''''''''''
----------------------------''''''''''''''''''''''''''''''''''''''''''''''''''''
''''''''''''''''''''''''''''''''''''''''''''''''''''''''''''''''''''''''''''''''
''''''''''''''''''''''''''''''''''''''''''''''''''''''''''''''''''''''''''''''''
''''''''''''''''''''''''''''''''''''''''''''''''''''''''''''''''''''''''''''''''
''''''''''''''''''''''''''''''''''''''''''''''''''''''''''''''''''''''''''''''''
''''''''''''''''''''''''''''''''''''''''''''''''''''''''''''''''''''''''''''''''
''''''''''''''''''''''''''''''''''''''''''''''''''''''''''''''''''''''''''''''''
''''''''''''''''''''''''''''''''''''''''''''''''''''''''''''''''''''''''''''''''
''''''''''''''''''''''''''''''''''''''''''''''''''''''''''''''''''''''''''''''''
''''''''''''''''''''''''''''''''''''''''''''''''''''''''''''''''''''''''''''''''
''''''''''''''''''''''''''''''''''''''''''''''''''''''''''''''''''''''''''''''''
''''''''''''''''''''''''''''''''''''''''''''''''''''''''''''''''''''''''''''''''
''''''''''''''''''''''''''''''''''''''''''''''''''''''''''''''''''''''''''''''''