''''''''''''''''''''''''''''''''''''''''''''''''''''''''''''''''''''''''''''''''
--------''''''''''''''''''''''''''''''''''''''''''''''''''''''''''''''''''''''''
|......|''''''''''''''''''''''''''''''''''''''''''''''''''''''''''''''''''''''''
|......=###################################################################'''''
|......|''''''''''''''''''''''''''''''''''''''''''''''''''''''''''''''''''#'''''
--------''''''''''''''''''''''''''''''''''''''''''''''''''#################'''''
''''''''''''''''''''''''''''''''''''''''''''''''''''''''''#'''''''''''''''''''''
''''''''''''''''''''''''''''''''''''''''''''''''''''''''''#'''''''''''''''''''''
''''''''''''''''''''''''''''''''''''''''''''''''''''''''''#''''---------------''
''''''''''''''''''''''''''''''''''''''''''''''''''''''''''#''''|.............|''
''''''''''''''''''''''''''''''''''''''''''''''''''''''''''#####=.............|''
'''''''''''''''''''''''''''''''''''''''''''''''''''''''''''''''|.............|''
'''''''''''''''''''''''''''''''''''''''''''''''''''''''''''''''|.............|''
'''''''''''''''''''''''''''''''''''''''''''''''''''''''''''''''|.............|''
'''''''''''''''''''''''''''''''''''''''''''''''''''''''''''''''---------------''
''''''''''''''''''''''''''''''''''''''''''''''''''''''''''''''''''''''''''''''''
''''''''''''''''''''''''''''''''''''''''''''''''''''''''''''''''''''''''''''''''
''''''''''''''''''''''''''''''''''''''''''''''''''''''''''''''''''''''''''''''''
''''''''''''''''''''''''''''''''''''''''''''''''''''''''''''''''''''''''''''''''
''''''''''''''''''''''''''''''''''''''''''''''''''''''''''''''''''''''''''''''''
''''''''''''''''''''''''''''''''''''''''''''''''''''''''''''''''''''''''''''''''
''''''''''''''''''''''''''''''''''''''''''''''''''''''''''''''''''''''''''''''''
''''''''''''''''''''''''''''''''''''''''''''''''''''''''''''''''''''''''''''''''
''''''''''''''''''''''''''''''''''''''''''''''''''''''''''''''''''''''''''''''''
''''''''''''''''''''''''''''''''''''''''''''''''''''''''''''''''''''''''''''''''
''''''''''''''''''''''''''''''''''''''''''''''''''''''''''''''''''''''''''''''''
''''''''''''''''''''''''''''''''''''''''''''''''''''''''''''''''''''''''''''''''
''''''''''''''''''''''''''''''''''''''''''''''''''''''''''''''''''''''''''''''''